
100000001

1ECP00001
111111111