1111111
11111111
1100001
111PEC1
1111111